S## ## ########
 ## #     ## ##
      ### ## ##
## # ###      #
   # ###### ###
## ####  ##   #
## #### #######
##       ######
## #### ###   #
#   ## # ### ##
##### #     # #
# #   ####### #
# # #         #
#   ###########
###           F