S## ## ########
 ## #     ## ##
      ### ## ##
## # ###      #
   # ###### ###
## ####  ##   #
## #### #######
##       ######
## #### ###   #
#   ##   ##  ##
#####  #    # #
# #   ####### #
# # #         #
#   ###########
###          FJ