S## ## ########
 ## #     #   #
      ### ## ##
## # ##       #
   #  ##### ###
 # ## #  #    #
 # #### #######
##       #  # #
## #### ###   #
#   ##   ##  ##
#####  #    # #
# #   ####### #
# # #         #
#   ###########
###          FJ